ZZZZZZZZZZZZZZZZZZZZZZZZZZZZZZZZZZZZZZZZZZZZZZZZZZZZZZZZZZZZZZZZZZZZZZZZZZZZ
Z                                                                          Z
Z    ZZZZZZZZZZZZZZZZZZZZZZZZZZZZZZZZZZZZZZZZZZZZZZ                        Z
Z    Z                                            Z                        Z
Z    Z                                            Z                        Z
Z    Z                                            Z                        Z
Z    Z                                            Z                        Z
Z    Z b b       b b                              Z                        Z
Z    ZZ    ZZZZZZ    ZZZZZZZZZZZZZZZZZZZYYZZZZZZZZZ                        Z
Z     ZRRRRZZZZZZBBBBZ                 Z  Z                                Z
Z     Z              Z                 Z  Z                                Z
Z     Z..............Z                 Z  Z                                Z
Z    ZZ              ZZ                ZBBZ                                Z
Z    Z                Z                Z  Z                                Z
Z    Z                ZZZZZZZZZZZZZZZZZZ..ZZZZZZZZZZZZZ                    Z
Z    Z                              z  A  A        c  Z                    Z
Z    Z                                 A  A           Z                    Z
Z    Za a a a a a a a ZZZZZZZZZZZZZZZZZZ..ZZZZZZZZZZZZZ                    Z
Z    Z                Z                Z  Z                                Z
Z    ZRRRRRBBBBBBYYYYYZ                Z  Z                                Z
Z    Z                Z  ZZZZZZZZ      Z  Z                                Z
Z    Z................Z  Z      Z      Zc Z                                Z
Z    Z                ZZZZ      Z      Z  Z                                Z
Z    Z                      s   Z      ZZZZ                                Z
Z    Z                          Z                                          Z
Z    Z                ZZZZ      Z                                          Z
Z    ZZZZZZZZZZZZZZZZZZ  Z      Z                                          Z
Z                        ZZZZZZZZ                                          Z
Z                                                                          Z
Z                                                                          Z
Z                                                                          Z
Z                                                                          Z
Z                                                                          Z
Z                                                                          Z
Z                                                                          Z
Z                                                                          Z
Z                                                                          Z
Z                                                                          Z
Z                                                                          Z
Z                                                                          Z
Z                                                                          Z
Z                                                                          Z
Z                                                                          Z
Z                                                                          Z
Z                                                                          Z
Z                                                                          Z
Z                                                                          Z
Z                                                                          Z
Z                                                                          Z
Z                                                                          Z
Z                                                                          Z
Z                                                                          Z
ZZZZZZZZZZZZZZZZZZZZZZZZZZZZZZZZZZZZZZZZZZZZZZZZZZZZZZZZZZZZZZZZZZZZZZZZZZZZ                     
                                                                                   


                   
                   
                   
                   
                   
         
         
         
         
         










                  
