############################################################################
#               ##########################################                 #
#               #                                                          #
#               #                                                 ##       #
#     ##        #                                                 ##       #
#     ##           ##########   #                                 ##       #
#     ##        #               #                                 ##       #
#     ##        #               #                                ##        #
#     ##        #               #                               ##         #
#     ##        #        #      #                               ##         #
#     ##        #        #      #                               ##         #
#     ##        #        #      #                               ##         #
#     ##        #        #####  #####################           ##         #
#     ##        #        #                                      ##         #
#     ##        #        #                                      ##         #
#     ##           #     #   ##################                 ##         #
#     ##           #     #                    #                 ##         # 
#     ##           #     #                    #                 ##         # 
#     ###########  #     #################    #                 ##         # 
#     ###########  #                          #                 ##         # 
#     ##           #                          #                 ##         #
#     ##           ####################       #                 ##         #
#     ##                              #       ##                ##         #
#     ##                              #       ##                ##         #
#     ##        ###################   #        #                ##         #
#     ##        #                 #   #        #               ##          #
#     ##        #                 #   #        #              ##           #
#     ##        #                 #   #        #             ##            #
#     ##        #                 ##############            ##             #
#               #                                          ##              #
#               #                                                          #
#               #                                                          #
############################################################################                     
                                                                                   
