############################################################################
#                                                                          #
#                                                                          #
#                                                                          #
#                                                                          #
#                                                                          #
#                                                                          #
#                                                                          #
#                                                                          #
#                                                                          #
#                                                                          #
#                                                                          #
#                                                                          #
#                                                                          #
#                                    ...............                       #
#         RRRR   BBBB   YYYY         .             .                       #
#         Rc R   Bc B   Yc Y         .     k       .                       #
#         R  R   B  B   Y  Y         .             .                       #
#         RRRR   BBBB   YYYY         .             .                       #
#                                    .             .                       #
#                                    .             .                       #
#                                    .             .                       #
#                                    .             .                       #
#                                    .             .                       #
#                                    .             .                       #
#                                    ...............                       #
#                                                                          #
#                                                                          #
#                                                                          #
#                                                                          #
#                                                                          #
#                                                                          #
#                   l                                                      #
#                                                                          #
#                                                                          #
#                                                                          #
#                                                                          #
#                                                                          #
#                                                                          #
#                                                                          #
#                                                                          #
#                                                                          #
#                                                                          #
#                                                                          #
#                                                                          #
#                                                                          #
#                                                                          #
#                                                                          #
#                                                                          #
#                                                                          #
#                                                                          #
#                                                                          #
############################################################################                     
                                                                                   


                   
                   
                   
                   
                   
         
         
         
         
         










                  
