############################################################################
#                                                                          #
#                                                                          #
#                                                                          #
#                                                                          #
#                                                                          #
#                                                                          #
#                                                                          #
#                                                                          #
#                                                                          #
#                                                                          #
#                                                                          #
#                                                                          #
#                                                                          #
#                                                                          #
#         RRRR   BBBB   YYYY                                               #
#         Rc R   Bc B   Yc Y                                               #
#         R  R   B  B   Y  Y                                               #
#         RRRR   BBBB   YYYY                                               #
#                                                                          #
#                                                                          #
#                                           k                              #
#                                                                          #
#                                                                          #
#                                                                          #
#                                                                          #
#                                                                          #
#                                                                          #
#                                                                          #
#                                                                          #
#                                                                          #
#                                                                          #
#                                                                          #
#                                                                          #
#                                                                          #
#                                                                          #
#                                                                          #
#                                                                          #
#                                                                          #
#                                                                          #
#                                                                          #
#                                                                          #
#                                                                          #
#                                                                          #
#                                                                          #
#                                                                          #
#                                                                          #
#                                                                          #
#                                                                          #
#                                                                          #
#                                                                          #
#                                                                          #
############################################################################                     
                                                                                   


                   
                   
                   
                   
                   
         
         
         
         
         










                  
