############################################################################
#                           ##################                             #
#                           ##################                             #
#                           ##################                             #
#                           ##################                             #
#                           ##################                             #
#                           ##################                             #
#                           ##################                             #
#                           ##################                             #
#                           ##################                             #
#                           ##################                             #
#                           ##################                             #
#                           ##################                             #
#                           ##################                             #
#                           ##################                             #
#          c                ##################                             #
#                           ##################                             #
#                           ##################                             #
#                           ##################                             #
#                           ##################                             #
#                           ##################                             #
#                                                                          #
#                                                                          #
#                           #                #                             #
#                           #                #                             #
#                           #                #                             #
#                           #                #                             #
#                           #                #                             #
#                           #                #                             #
#                           #                #                             #
#                           #                #                             #
#                           #                #                             #
#                           #                #                             #
#                           #                #                             #
#                                                                          #
#                                                                          #
#                                                                          #
#                           ##################                             #
#                           ##################                             #
#                           ##################                             #
#                           ##################                             #
#                           ##################                             #
#                           ##################                             #
#                           ##################                             #
#                           ##################                             #
#                           ##################                             #
#                           ##################                             #
#                           ##################                             #
#                           ##################                             #
#                           ##################                             #
#                           ##################                             #
#                           ##################                             #
############################################################################                     
                                                                                   


                   
                   
                   
                   
                   
         
         
         
         
         










                  
