############################################################################
#                           ##################                             #
#                           ##################                             #
#                           ##################                             #
#                           ##################                             #
#           y               ##################                             #
#                           ##################                             #
#                           ##################                             #
#                           ##################                             #
#                           ##################                             #
#                           ##################                             #
#                           ##################                             #
#                           ##################                             #
#                           ##################                             #
#                           ##################                             #
#          c                ##################                             #
#                           ##################                             #
#                           ##################                             #
#                           ##################                             #
#                           ##################                             #
#             y             ##################                             #
#                                                                          #
#                                                                          #
#                           #                #                             #
#                           #                #                             #
#                           #                #                             #
#                           #                #                             #
#                           #                #                             #
#                           #                #                             #
#                           #                #                             #
#                           #                #                             #
#                           #                #             y               #
#                           #                #                             #
#                           #                #                             #
#                                                                          #
#                                                                          #
#                                                                          #
#                           ##################                             #
#                           ##################                             #
#                           ##################                             #
#                           ##################                             #
#                           ##################                             #
#                           ##################                             #
#                           ##################                             #
#                           ##################                             #
#                           ##################                             #
#                           ##################                             #
#                           ##################                             #
#                           ##################                             #
#                           ##################                             #
#                           ##################                             #
#                           ##################                             #
############################################################################                     
                                                                                   


                   
                   
                   
                   
                   
         
         
         
         
         










                  
