ZZZZZZZZZZZZZZZZZZZZZZZZZZZZZZZZZZZZZZZZZZZZZZZZZZZZZZZZZZZZZZZZZZZZZZZZZZZZZZZZZZZZZZZZZZZZZZZZZZZZZ
ZZZZZZZZZZZZZZZZZZZZZZZZZZZZZZZZZZZZZZZZZZZZZZZZZZZZZZZZZZZZZZZZZZZZZZZZZZZZZZZZZZZZZZZZZZZZZZZZZZZZZ
ZZZZZZZZZZZZZZZZZZZZZZZZZZZZZZZZZZZZZZZZZZZZZZZZZZZZZZZZZZZZZZZZZZZZZZZZZZZZZZZZZZZZZZZZZZZZZZZZZZZZZ
ZZZZ           ZZZZZZZZZZZZZZZZZZZZZZZZZZZZZZZZZZZZZZZZZZZZZZZZZZZZZZZZZZZZZZZZZZZZZZZZZZZZZZZZZZZZZZ
ZZZZ                                                                                 FF       ZZZZZZZ
ZZZZ                                                                                FF         ZZZZZZ
ZZZZ           ZZZZZZZZZZZZZZZZZ      .      ZZZZZZZZZZZZZZZZZZZZZ                 FF    t      ZZZZZ
ZZZZ           ZZZZZZZZZZZZZZZZZ      .      ZZZZZZZZZZZZZZZZZZZZZ               ZZZZ           ZZZZZ
ZZZZ           ZZZZZZZZZZZZZZZZZ    . . .    ZZZZZZZZZZZZZZZZZZZZZ               ZZZZ          ZZZZZZ
ZZZZ           ZZZZZZZZZZZZZZZZZ     ...     ZZZZZZZ    y    ZZZZZ               ZZZZZ        ZZZZZZZ
ZZZZZZZZZZZZZZZZZZZZZZZZZZZZZZZZ      .      ZZZZZZZ         ZZZZZ               ZZZZZZZZZZZZZZZZZZZZ
ZZZZZZZZZZZZZZZZZZZZZZZZZZZZZZZZ             ZZZZZZZZZZZRRRRZZZZZZ               ZZZZZZZZZZZZZZZZZZZZ
ZZZZZZZZZZZZZZZZZZZZZZZZZZZZZZZZ             ZZZZZZZ             j               ZZZZZZZZZZZZZZZZZZZZ
ZZZZZZZZZZZZZZZZZZZZZZZZZZZZZZZZ             ZZZZZZZ                             ZZZZZZZZZZZZZZZZZZZZ
ZZZZZZZZZZZZZZZZZZZZZZZZZZZZZZZZ             ZZZZZZZ             j               ZZZZZZZZZZZZZZZZZZZZ
ZZZZZZZZZZZZZZZZZZZZZZZZZZZZZZZZ             ZZZZZZZ                     ZZYYYYYYZZZZZZZZZZZZZZZZZZZZ
ZZZZZZZZZZZZZZZZZZZZZZZZZZZZZZZZ             ZZZZZZZZZZZZZZZZZZZZZZZZZZZZZ        ZZZZZZZZZZZZZZZZZZZ
ZZZZZZZZZZZZZZZZZZZZZZZZZZZZZZZZiiiiiiiiiiiiiZZZZZZZZZZZZZZZZZZZZZZZZZZZZ          ZZZZZZZZZZZZZZZZZZ
Z                           ZZZ               ZZZ                     ZZ            ZZ              Z
Z                         ZZ                     ZZ                   ZZ   c   c    ZZ              Z
Z                        Z                         Z                  ZZ            ZZ              Z
Z                       Z               Z           Z                  ZZ          ZZ               Z
Z                      Z               ZZZ           Z                  ZZ        ZZ                Z
Z                     Z               ZZ ZZ           Z                  ZZZZZZZZZZ                 Z
Z                     Z              ZZ   ZZ          Z                                             Z
Z                    Z              ZZ     ZZ          Z                                            Z
Z                    Z             ZZ   s   ZZ         Z                                            Z
Z                    Z            ZZ         ZZ        Z                                            Z
Z                     Z           ZZZZZZZZZZZZZ       Z                                             Z
Z                     Z                               Z                                             Z
Z                      Z                             Z                                              Z
Z                       Z                x          Z                                               Z
Z                        Z                         Z                                                Z
Z                         ZZ                     ZZ                                                 Z
Z                           ZZZ               ZZZ                                                   Z
Z                              ZZZZZZZZZZZZZZZ                                                      Z
Z                                                                                                   Z
Z                                                                                                   Z
Z                                                                                                   Z
Z                    Z                                                                              Z
Z                                                                                                   Z
ZZZZZZZZZZZZZZZZZZZZZZZZZZZZZZZZZZZZZZZZZZZZZZZZZZZZZZZZZZZZZZZZZZZZZZZZZZZZZZZZZZZZZZZZZZZZZZZZZZZZZ
ZZZZZZZZZZZZZZZZZZZZZZZZZZZZZZZZZZZZZZZZZZZZZZZZZZZZZZZZZZZZZZZZZZZZZZZZZZZZZZZZZZZZZZZZZZZZZZZZZZZZZ
ZZZZZZZZZZZZZZZZZZZZZZZZZZZZZZZZZZZZZZZZZZZZZZZZZZZZZZZZZZZZZZZZZZZZZZZZZZZZZZZZZZZZZZZZZZZZZZZZZZZZZ
ZZZZZZZZZZZZZZZZZZZZZZZZZZZZZZZZZZZZZZZZZZZZZZZZZZZZZZZZZZZZZZZZZZZZZZZZZZZZZZZZZZZZZZZZZZZZZZZZZZZZZ
ZZZZZZZZZZZZZZZZZZZZZZZZZZZZZZZZZZZZZZZZZZZZZZZZZZZZZZZZZZZZZZZZZZZZZZZZZZZZZZZZZZZZZZZZZZZZZZZZZZZZZ
ZZZZZZZZZZZZZZZZZZZZZZZZZZZZZZZZZZZZZZZZZZZZZZZZZZZZZZZZZZZZZZZZZZZZZZZZZZZZZZZZZZZZZZZZZZZZZZZZZZZZZ
ZZZZZZZZZZZZZZZZZZZZZZZZZZZZZZZZZZZZZZZZZZZZZZZZZZZZZZZZZZZZZZZZZZZZZZZZZZZZZZZZZZZZZZZZZZZZZZZZZZZZZ
ZZZZZZZZZZZZZZZZZZZZZZZZZZZZZZZZZZZZZZZZZZZZZZZZZZZZZZZZZZZZZZZZZZZZZZZZZZZZZZZZZZZZZZZZZZZZZZZZZZZZZ
ZZZZZZZZZZZZZZZZZZZZZZZZZZZZZZZZZZZZZZZZZZZZZZZZZZZZZZZZZZZZZZZZZZZZZZZZZZZZZZZZZZZZZZZZZZZZZZZZZZZZZ
ZZZZZZZZZZZZZZZZZZZZZZZZZZZZZZZZZZZZZZZZZZZZZZZZZZZZZZZZZZZZZZZZZZZZZZZZZZZZZZZZZZZZZZZZZZZZZZZZZZZZZ
ZZZZZZZZZZZZZZZZZZZZZZZZZZZZZZZZZZZZZZZZZZZZZZZZZZZZZZZZZZZZZZZZZZZZZZZZZZZZZZZZZZZZZZZZZZZZZZZZZZZZZ
ZZZZZZZZZZZZZZZZZZZZZZZZZZZZZZZZZZZZZZZZZZZZZZZZZZZZZZZZZZZZZZZZZZZZZZZZZZZZZZZZZZZZZZZZZZZZZZZZZZZZZ
